############
#..........#
#..........#
#..........#
#.....@....#
############