############
#..#...#...#
#.@........#
#....#.#...#
##.#....#..#
############