############
#..#.......#
#.@........#
#....#.....#
##......#..#
############